first amendment	first_amendment
second amendment	second_amendment
third amendment	third_amendment
fourth amendment	fourth_amendment
fifth amendment	fifth_amendment
sixth amendment	sixth_amendment
seventh amendment	seventh_amendment
eighth amendment	eighth_amendment
ninth amendment	ninth_amendment
tenth amendment	tenth_amendment
eleventh amendment	amendmentxi
twelfth amendment	amendmentxii
thirteenth amendment	amendmentxiii
fourteenth amendment	amendmentxiv
fifteenth amendment	amendmentxv
sixteenth amendment	amendmentxvi
seventeenth amendment	amendmentxvii
eighteenth amendment	amendmentxviii
nineteenth amendment	amendmentxix
twentieth amendment	amendmentxx
twenty - first amendment	amendmentxxi
twenty - second amendment	amendmentxxii
twenty - third amendment	amendmentxxiii
twenty - fourth amendment	amendmentxxiv
twenty - fifth amendment	amendmentxxv
twenty - sixth amendment	amendmentxxvi
twenty - seventh amendment	amendmentxxvii
free speech	first_amendment
free exercise	first_amendment
freedom of speech	first_amendment
establishment of religion	first_amendment
free exercise of religion	first_amendment
commerce clause	articlei#section8
due process	fifth_amendment
due process clause	fifth_amendment
clue process clause	fifth_amendment
equal protection	amendmentxiv
privileges and immunities	articleiv#section2
full faith and credit	articleiv#section1
cruel and unusual	eighth_amendment
keep and bear arms	second_amendment
speedy trial	sixth_amendment
excessive bail	eighth_amendment
excessive fines 	eighth_amendment